11111111111
111000000E1
111000000C1
100000000P1
11111111111