11111111111111111111111
10000000000000000000001
100100000000000000000C1
110C01100000000000000C1
111E0000000000000000PC1
11111111111111111111111