11111111111
111111100E1
11111111PC1
11111111111